Бгуор|БРЯНСКОЕ ГОСУДАРСТВЕННОЕ УЧИЛИЩЕ (КОЛЛЕДЖ) ОЛИМПИЙСКОГО РЕЗЕРВА|Брянское училище (колледж) олимпийского резерва|Колледж БГУОР|Бкфк|ФГБУ ПОО «БГУОР»|БУГОР ОЛИМПИЙСКОГОРЕЗЕРВА’’|БГУОР"ОЛИМПИЙСКОГОРЕЗЕРВА"|БГУОР г. Брянск|Бугор,,Олимпийского резерва’’|Брянское Государственное Училище Олимпийского Резерва|ФГУБУ ПОО «БГУОР»|
БГИТУ|Брянский государственный инженерно-технологический университет|
ВШЭ|НИУ ВШЭ|Национальный исследовательский университет «Высшая школа экономики» (НИУ ВШЭ)|Высшая школа экономики|
КГУФКСТ|Кубанский государственный университет физической культуры, спорта и туризма|
МГИМО|МГИМО (У) МИД|Московский государственный институт международных отношений|
МГМСУ|Московский государственный медико-стоматологический университет имени А. И. Евдокимова|МГМСУ им А И Евдокимова|МГМСУ им Евдокимова|МГМСУ им А.И. Евдокимова|МГМСУ им.А.И.Евдокимова|
МАИ|Московский авиационный институт|НИУ МАИ|
МГТУ "СТАНКИН"|
МГАВМИБ им. К.И. Скрябина|
МГМУ им. И.М. Сеченова|ПМГМУ им. И.М. Сеченова|ПМГМУ им. Сеченова|Сеченовский университет|
МГПУ|Московский городской педагогический университет|
МГТУ им Н.Э. Баумана|Мгту им Баумана|МГТУ им. Баумана|Московский Государственный Технический университет МГТУ им. Н.Э.Баумана|МГТУ имени Баумана|МГТУ им.Баумана|МГТУИМ.БАУМАНА|МГТУ ИМ Н.Э БАУМАНА|МГТУ ИМН Э БАУМАНА|МГТУ им. Н. Э. Баумана|
МГТУ СТАНКИН|Станкин|
МГУПП|Московский государственный университет пищевых производств|
РТУ МИРЭА|МИРЭА|
МИФИ|Московский инженерно-физический институт|НИЯУ МИФИ|Национальный исследовательский ядерный университет «МИФИ»|НИЯУ МИФИ - Национальный исследовательский ядерный университет|НИЯУ «МИФИ»|
МИЭТ|Московский институт электронной техники|
МПГУ|Московский педагогический государственный университет|
МФПУ «Синергия»|Московский финансово-промышленный университет „Синергия“|Московский финансово-промышленный университет|Синергия|
МФТИ|Московский физико-технический институт|НИУ МФТИ|
РГГРУ-МГРИ|Российский Государственный Геологоразведочный Университет|
РГСУ|Российский государственный социальный университет|
РГУ им Косыгина|Ргу им. А. Н. Косыгина|РГУ им.Косыгина|РГУИМ КОСЫГИНА|РГУИМКОСЫГИНА|
РНИМУ|Российский национальный исследовательский медицинский университет имени Н. И. Пирогова|РНИМУ им. Н. И. Пирогова|РНИМУ Им. Пирогова|ФГБОУ ВО РНИМУ ИМ Н И ПИРОГОВА МЗ РОССИИ|РНИМУИМН И ПИРОГОВА|РНИМУ им Н.И. Пирогова|
РХТУ им. Д.И.Менделеева|Российский химико-технологический университет имени Д. И. Менделеева|РХТУ им Д.И. Менделеева|РХТУ Д.И. Менделеева|РХТУ|
РЭУ им. Г. В. Плеханова|РЭУ|РЭУ им. Г. В. Плеханова|РЭУ им Г В Плеханова|РЭУ им Г. В. Плеханова|РЭУИМГ.В.ПЛЕХАНОВА|
ТПУ|Томский политехнический университет|
ФУ РФ|Финансовый университет при Правительстве РФ|
ЯрГУ|ЯрГУ им. П. Г. Демидова|ЯрГУ имени П. Г. Демидова|Ярославский государственный университет им. П.Г. Демидова|ЯрГУ им Демидова|ЯрГУ им И. П. Демидова|ЯрГУ им П.Г. Демидова|ЯрГУ им. Демидова|ЯрГУ им.Демидова|ЯрГУ имени Демидова|Ярославский государственный университет им. П. Г. Демидова|Ярославский государственный университет им.Демидова|Ярославский государственный университет имени Демидова|ФГБОУВО"ЯРОСЛАВСКИЙГОСУДАРСТВЕННЫЙУНИВЕРСИТЕТИМ.ДЕМИДОВА"|
МГРИ-РГГРУ им. Серго Орджоникидзе|